111111111111111111111111111111111
1P00000C00000C00000C00000C00000C1
111111111111111111111111111111101
100C00000C00000C00000C00000C00001
101111111111111111111111111111111
100C00000C00000C00000C00000C00001
111111111111111111111111111111101
1C00000C00000C00000C00000C00000C1
101111111111111111111111111111111
10000C00000C00000C00000C00000C001
111111111111111111111111111111101
10000C00000C00000C00000C00000C001
101111111111111111111111111111111
1C00000C00000C00000C00000C00000C1
111111111111111111111111111111101
100C00000C00000C00000C00000C00001
101111111111111111111111111111111
100C00000C00000C00000C00000C000E1
111111111111111111111111111111111
