1111111111111111111111111
1P00000C00000C00000C00001
1111111111111111111111101
10000C00000C00000C00000C1
1011111111111111111111111
1C00000C00000C00000C00001
1111111111111111111111101
10000C00000C00000C00000C1
1011111111111111111111111
1C00000C00000C00000C00001
1111111111111111111111101
10000C00000C00000C00000C1
1011111111111111111111111
1C00000C00000C00000C000E1
1111111111111111111111111
