1111111111111111111111111111111111111111
1P00000C00000C00000C00000C00000C00000C01
1111111111111111111111111111111111111101
10000C00000C00000C00000C00000C00000C0001
1011111111111111111111111111111111111111
1C00000C00000C00000C00000C00000C00000C01
1111111111111111111111111111111111111101
10000C00000C00000C00000C00000C00000C0001
1011111111111111111111111111111111111111
1C00000C00000C00000C00000C00000C00000C01
1111111111111111111111111111111111111101
10000C00000C00000C00000C00000C00000C0001
1011111111111111111111111111111111111111
1C00000C00000C00000C00000C00000C00000C01
1111111111111111111111111111111111111101
10000C00000C00000C00000C00000C00000C0001
1011111111111111111111111111111111111111
1C00000C00000C00000C00000C00000C00000C01
1111111111111111111111111111111111111101
10000C00000C00000C00000C00000C00000C0001
1E11111111111111111111111111111111111111
1111111111111111111111111111111111111111
