11111111111111111111111111111111111111111111111111111111111
1P1000000000000010000000100000000000001000000010C0001000001
101110111111111011101110111C1110111110101110101110101011101
1010001000100010000010100010001010001C100010100010100010001
101C1110111010111111101110101011101010111110111011101110111
10100010000010000000001000101010001010000000101000100010001
10111011111111111011101011101010111011111111101110111111101
10000010000000000010001000101010001000100000000010100000001
11111110111111111110111110111010111110101110111010101111101
100000001000000000000000100010101000001000101E1010001000101
10111110101111101111111111101010101111101110101011111011101
101000101010001010000000000010001000001010001C1000000010001
10101010111010111011111111111011111110101011101111111010111
101010101C0010001010000000100010100000101010000000000010101
10101110101111101010111111101110101111101011111111111110101
1010100010100C10101000000010000010000010100010000C000000101
1010101110101010101011111010111111111011111C101111111111101
10001000101010001010100010001000000000100000100000000010001
11101110101011111010101011111011111111101111111111111010101
100010C01010000C101010100010001000000000100000001000100C101
10111C11101111101011101110101110101111101011101110101111101
10101000001000101010001000101000100C00101010100000100000101
10101111111011101010111011101111111110101010111111111110101
10100000100010001010001010000000001000101000100010000010001
10101110111010111011101011111111101011111110101011111011111
1000100000001000000000100000000000100000000000100000C000001
11111111111111111111111111111111111111111111111111111111111
