11111
1PXC1
10001
1E001
11111
