11111
1P0C1
10001
10001
11111
