11111
1P0C1
10E01
1E001
11111
